1111111111
1000010001
10010C0001
1000010001
10010C0001
101P010001
10CE010001
1111111111
