11111111111111111111
100000010B0100000001
10000001000000000001
10000001CL0110000001
10000000101100000001
1000000010100X000001
10000000101000000001
10000111101111000001
10000100000001111101
10000101001001000001
10000001C01000100001
100000X0110000000101
100000000000000001E1
10CC0CC0001101100111
1C00C00C0100D0010001
1C00000C010000010001
10C010C00010C0100001
100C0C00000101000001
1000C000P00010000001
11111111111111111111
