111111
100001
1X0B01
10CX01
1R0001
1P0DD1
101CE1
111111
