111111111111111111
100011111000000001
100010001000000001
10001X001000000001
1011100X1100000001
10100X0X0100000001
111010110100111111
10001011011100BB11
10X00X00000000BB11
11111011101P00BB11
10001000001D111111
11111111111C111111
11111111111E111111
111111111111111111
