1111111111111111
100000110C010001
10000010b0010001
1000001011X11101
1111111011C0X111
110000001X0X11C1
1E00000010X00101
10000000110001D1
1000011111110001
1000000010000111
1D1011101R000001
1010XR00DB100001
1D11D111111X0011
1B00000001000011
10000000P0000011
1000000000000011
1000000000000011
1111111111111111
