111111111111111111
1010101011000C0001
110101010100110001
111111111111C00001
1000000XB100000001
100R000E0000000001
10000000X010100001
1000C0000010100001
100000000000000001
1000000100R0000101
100000001D111D10P1
100000001000C01101
100000001111111001
111111111111111111
