1111111111
100001RRR1
10010C0001
1L0L010R01
10010C0001
101P010001
10CE010001
1111111111
