111111111111111111111
100111001011111111101
100100001010000000111
100100001110111110011
100010X00C00100E10011
100010100000100010011
10001B111000111D11011
1000100010000000010C1
1000101010101111X1011
11111X110110111101011
1B0C0000X000111100011
111110111110R00001111
10001011111D1111C1001
1000000000000001D1001
10000P000000000000001
111111111111111111111
