111111111111
111001100001
10010XC0R0B1
1000XX100001
100110C00001
1010P0100001
1010D0100001
10C1E1100001
111111111111
