1111111
1000P01
10C0001
1110001
10DB001
1E10001
1111111
